111111111111111111111111111111111111111111111111111111111111111111111111
100000001000000000000100000000000000000000000000000000000000000000000001
100000001000000000000100000000000000000000000000000000000000000000000001
100000011000111111111111111111111111111111111111110000000001000000000001
100000010000000000000011111111100000000000000000000000000000000000000001
100000010000000000000011111110000000000000000000000000000000000000000001
100000000000000000000000000000000000000000000000000000000000000000000001
100000000000000000000000000000000000000000000000000000000000000000000001
100000000000000000000000000000000000000000000000000000000000000000000001
100000000000000000000000000000001111111111111111111111111111111111111101
100000000000000000000000000000000000000000000000000000000000000000000001
100000000000000000000000000000000000000000000000000000000000000000000001
111111111111111111111111111111111111111111111111111111111111111111111111
